+----------------------+
|                      |
|              ###     |
|                      |
|   #########          |
|                      |
|                 #    |
+----------------------+
