+----------------------+
|                      |
|                      |
|                      |
|                      |
|           ###        |
| #                    |
+----------------------+
